alecdavis = alecdavis <alecdavis>
anthm = anthm <anthm>
anthonyl = anthonyl <anthonyl>
atis = atis <atis>
bbryant = bbryant <bbryant>
beagles = beagles <beagles>
bkramer = bkramer <bkramer>
bkruse = bkruse <bkruse>
bmd = bmd <bmd>
bweschke = bweschke <bweschke>
citats = citats <citats>
citywok = citywok <citywok>
crichter = crichter <crichter>
ctooley = ctooley <ctooley>
dbailey = dbailey <dbailey>
dbrooks = dbrooks <dbrooks>
dhubbard = dhubbard <dhubbard>
diruggles = diruggles <diruggles>
dlee = dlee <dlee>
dsessions = dsessions <dsessions>
dvossel = dvossel <dvossel>
elguero = elguero <elguero>
eliel = eliel <eliel>
espiceland = espiceland <espiceland>
file = file <file>
ghenry = ghenry <ghenry>
igorg = igorg <igorg>
irroot = irroot <irroot>
jamesgolovich = jamesgolovich <jamesgolovich>
jcollie = jcollie <jcollie>
jdixon = jdixon <jdixon>
jeang = jeang <jeang>
jeffg = jeffg <jeffg>
jeremy = jeremy <jeremy>
jim = jim <jim>
jmls = jmls <jmls>
jpeeler = jpeeler <jpeeler>
jrose = jrose <jrose>
jsmith = jsmith <jsmith>
juggie = juggie <juggie>
junky = junky <junky>
kmoore = kmoore <kmoore>
kpfleming = kpfleming <kpfleming>
lathama = lathama <lathama>
lmadsen = lmadsen <lmadsen>
malcolmd = malcolmd <malcolmd>
markm = markm <markm>
markster = markster <markster>
marquis = marquis <marquis>
martinp = martinp <martinp>
matteo = matteo <matteo>
mattf = mattf <mattf>
may = may <may>
mjordan = mjordan <mjordan>
mmichelson = mmichelson <mmichelson>
mnicholson = mnicholson <mnicholson>
mnick = mnick <mnick>
mogorman = mogorman <mogorman>
moy = moy <moy>
murf = murf <murf>
mvanbaak = mvanbaak <mvanbaak>
nadi = nadi <nadi>
newtonr = newtonr <newtonr>
(no author) = (no author) <(no author)>
north = north <north>
oej = oej <oej>
pabelanger = pabelanger <pabelanger>
pari = pari <pari>
pcadach = pcadach <pcadach>
phsultan = phsultan <phsultan>
pitel = pitel <pitel>
pkiefer = pkiefer <pkiefer>
qwell = qwell <qwell>
rbrindley = rbrindley <rbrindley>
rizzo = rizzo <rizzo>
rmudgett = rmudgett <rmudgett>
russell = russell <russell>
schmidts = schmidts <schmidts>
schmitds = schmitds <schmitds>
seanbright = seanbright <seanbright>
simon.perreault = simon.perreault <simon.perreault>
snuffy = snuffy <snuffy>
sruffell = sruffell <sruffell>
tholo = tholo <tholo>
tilghman = tilghman <tilghman>
transnexus = transnexus <transnexus>
tringenbach = tringenbach <tringenbach>
twilson = twilson <twilson>
twisted = twisted <twisted>
tzafrir = tzafrir <tzafrir>
voicetronix = voicetronix <voicetronix>
wdoekes = wdoekes <wdoekes>
wedhorn = wedhorn <wedhorn>
wmeadows = wmeadows <wmeadows>
